R.I.P -- Light Engine
AnthemOverload -- has a big penis
Techsec is -- Horrid
Kickafly -- Big Muscles
IM GONNA -- EAT MVP CARROT
check out kickacraft -- for the lore
HD has dementia -- wait what was i gonna say
ItsPixel -- has Big Boobs
Blend -- smh u fell off
Also try -- Light Engine
dont play -- vs chris pratt
cock -- penis
Light Engine -- my beloved
wyxos -- had a good run
fuck you -- poyo
Also Try -- Vs TTS
V Two -- In the making
MVP HD -- is a prick
god is not real -- HD 2021
Play FNF poppin off -- when its out
The Funkshitters -- best team
well you see kickafly -- in the art of war
sky is hot -- not the one from the mod
Hi -- Hi
Ganerzone -- is infact a person
Dab -- likes kids
Aflac -- is B side HD
torment -- skill issue
The poop -- what
Epic moment -- Epic moment
I like -- big penis
Psych engine -- is good
Kade Engine -- fell off
FNF mobile community -- you suck
catofinn -- is 12
DONT GO INTO -- THE SECRET FOLDER
im -- dead
my day be so fine and then -- torment
Play -- Selever Blackberry